...###.......###....
.....#.###..##.#.#.#
.##..###.......###..
##........##........
#..#@#.#..#..#.#.#..
#.######..########..
..#..#......#..#....
.##.##...#.##.##.#.#
........##.#........
.#.....##........##.