####################
##...#####..##.#.###
###..###...........#
##........##.......#
#..#@#.#..#..#.#.#.#
#.######..########.#
#.#..#......#..#...#
#...##...#.##.##...#
##......##........##
####################