#######......#######
##......##..##.#.###
###.##.............#
##........##.......#
...#@#.#..#..#.#.#..
..######..########..
#.#..#......#..#...#
#...##...#.##.##...#
##......##........##
#######......#######