..............######################
..............#...........##.......#
..............#...........##.......#
###############.......##...........#
@......................#...........#
###############.............#......#
..............#...........###......#
..............#....................#
..............######################